R 900 900
NO ./texture/derevo.xpm
SO ./texture/feol.xpm
WE ./texture/kamen.xpm
EA ./texture/seriy_kamen.xpm

S ./texture/BAR1C0.xpm
F 220,100,100
C 225,30,0

   1111111111111111111111
1111000000000000000000001
10010000000000000000000001
10200000200020000200020001
1100N000000000000000000001
11111111111111111111111111